111111111111111111111111111111111111111111
100000001010000000000000000140010001000001
101110101010111111111111110101010101011101
101010101010100000000000010101010101010101
101010101010101101111111010101010101010101
101010101010101000000001010101010101010101
101010101010101011111101010101010111010001
101010101010101010000101010101010101010101
101010101010001010110111010101010101010101
101010100010101110130101010111010101010101
100010111010101010111101010101010101010101
111010101010101010000001010101010101011101
101010100010101011101111010101010101010101
101010101010101000000000010101010101010101
101010101000101111111111110101010101010101
101010101010100000000000000100010101000101
101011101110111111111111111101010101111101
100200100010000000000000000001000000000001
111111111111111111111111111111111111111111