11111111111111111111111111111111111111111111111111
12100000000000000001111111110000000111111011010001
10111110101011110100100000000111110000001001010101
10100010101010000110110111110000011111101101010101
10101010101011110100100100010111000000100101000101
10101000101000010110111101010101011110110101111101
10101011101111010010100001000101000010000000000001
10101010000001111011111101111101011011111111011101
10001010111100000000000001000000010000010000000131
11111111111111111111111111111111111111111111111111