1111111111111111111111111111111111111111111111111111
1000020000000000100000000000000000000400000000000001
1011111111110111111111101111111111111111111111111111
1000100000000000000000100000000000000000000000000101
1010101111111111111111111111111111111111111111110101
1010100000000000000000000000000000100000000000310001
1010111111111111111111111111111110111111111011110101
1010000000000000000000000000000000000000100000000101
1011111111111111111111111110111111111110111111111101
1010000000000000000000000000000000000100000000000001
1111111111111111111111111111111111111111111111111111
